11111111111111111111111
10000000000000000000011
10000000000000000000001
10001000000000C00011111
10001000P0000C000000001
1000100000000C000100001
1E00100000000C000000C01
11111111111111111111111
