1111111111111111111111111111
100000000P000000000000000011
10000000000000C0000000000001
1000000100000000000000111111
100000000000000X000000000011
100000000000100X000000000011
100010000X00000X010000000001
100010000E00000X000000111111
1111111111111111111111111111
