1111111111111111111111111111
1000000E0000000000C000000011
100000000000000P000000000001
100010000000000000C000111111
1111111111111111111111111111
