11111111111111111111111
10C00000000000000000011
1C000000000000000000001
100010000E0000C00011111
1000100000EP0C000000001
1000100000000C000100001
1E00100000000C000000C01
11111111111111111111111
