11111111111111111111111
10000000000000000000C11
1C000000000000000000001
10001000000000C00011111
10001000000P00000000001
10001C00000000000100001
1E001000000000000000C01
11111111111111111111111
